w w w w w w w w w w w w w
a s a s a s a s a s a s a
d f d f d f d f d f d f d
a s a s a s a s a s a s a
d f d f d f d f d f d f d
a s a s a s a s a s a s a
d f d f d f d f d f d f d
a s a s a s a s a s a s a
d f d f d f d f d f d f d
a s a s a s a s a s a s a
d f d f d f d f d f d f d
a s a s a s a s a s a s a